{
	"name":		"level20",
	"width":	10,
	"height":	15,
	"board_array":	[0, 0, 0, 0, 0, 0, 0, 11, 0, 0,
        0, 0, 0, 0, 0, 0, 0, 0, 0, 0,
        0, 0, 0, 0, 0, 0, 0, 0, 0, 0,
        0, 0, 0, 0, 0, 0, 0, 0, 0, 0,
        10, 0, 0, 0, 40, 0, 0, 0, 0, 47,
        1, 0, 0, 0, 2, 2, 0, 0, 0, 2,
        1, 0, 0, 0, 1, 2, 0, 0, 0, 2,
        1, 0, 0, 0, 1, 2, 0, 0, 0, 2,
        1, 61, 0, 0, 1, 2, 0, 0, 0, 2,
        1, 0, 0, 0, 1, 2, 0, 65, 0, 2,
        1, 0, 0, 0, 1, 2, 0, 0, 0, 2,
        1, 0, 0, 0, 1, 2, 2, 3, 2, 2,
        1, 0, 0, 61, 1, 2, 2, 2, 2, 2,
        1, 0, 0, 0, 1, 2, 2, 2, 2, 2,
        1, 3, 3, 3, 1, 2, 2, 2, 2, 2
    ],
	"signs":	[]
}