{
	"name":		"Makes You Stronger",
	"width":	13,
	"height":	13,
	"board_array":	[
						0,	0,	0,	0,	0,	0,	0,	0,	0,	0,	0,	0,	0,	
						0,	0,	0,	0,	0,	0,	0,	0,	0,	0,	0,	0,	0,	
						10,	0,	0,	0,	40,	0,	0,	0,	0,	47,	0,	0,	0,	
						1,	0,	0,	0,	2,	2,	0,	0,	0,	2,	0,	0,	0,	
						1,	0,	0,	0,	1,	2,	0,	0,	0,	2,	0,	0,	0,	
						1,	0,	0,	0,	1,	2,	0,	0,	0,	2,	0,	0,	0,	
						1,	61,	0,	0,	1,	2,	0,	0,	0,	2,	0,	0,	0,	
						1,	0,	0,	0,	1,	2,	0,	65,	0,	2,	0,	0,	0,	
						1,	0,	0,	0,	1,	2,	0,	30,	0,	2,	0,	0,	0,	
						1,	0,	0,	0,	1,	2,	2,	1,	2,	2,	0,	0,	0,	
						1,	0,	0,	61,	1,	2,	2,	2,	2,	2,	20,	20,	20,	
						1,	0,	0,	0,	1,	2,	2,	2,	2,	2,	0,	11,	0,	
						1,	3,	3,	3,	1,	2,	2,	2,	2,	2,	1,	1,	1
					],
	"signs":	[]
}