{
	"name":		"Stack 'em up",
	"width":	13,
	"height":	13,
	"board_array":	[	
						1,	1,	1,	1,	1,	0,	0,	0,	0,	1,	0,	0,	0,	
						1,	1,	1,	1,	1,	0,	0,	0,	0,	1,	0,	0,	0,	
						1,	1,	1,	1,	1,	10,	0,	0,	0,	1,	0,	0,	0,	
						1,	1,	1,	1,	1,	1,	1,	0,	0,	1,	0,	0,	0,	
						1,	1,	0,	0,	0,	0,	0,	0,	0,	1,	0,	0,	11,	
						1,	1,	0,	0,	0,	0,	0,	0,	0,	1,	0,	0,	1,	
						1,	1,	0,	5,	0,	0,	5,	0,	0,	1,	0,	0,	1,	
						1,	1,	0,	1,	1,	1,	1,	1,	1,	1,	0,	0,	1,	
						0,	0,	0,	0,	0,	0,	0,	0,	0,	0,	0,	0,	1,	
						0,	0,	0,	0,	0,	0,	0,	0,	0,	0,	0,	0,	1,	
						0,	0,	0,	0,	0,	0,	0,	0,	0,	0,	0,	0,	1,	
						1,	1,	0,	1,	1,	1,	1,	1,	1,	1,	1,	2,	1,
						1,	1,	1,	1,	1,	1,	1,	1,	1,	1,	1,	1,	1
					],
	"signs":	[]
}