{
	"name":		"level25B",
	"width":	13,
	"height":	12,
	"board_array":	[	
						0,	0,	0,	0,	0,	0,	0,	0,	0,	0,	0,	0,	0,
						10,	0,	0,	0,	0,	0,	0,	0,	0,	5,	0,	0,	4,
						1,	1,	22,	20,	0,	0,  0,	0,	1,	20,	1,	1,	4,
						1,  22,	21,	20,	0,	0,	0,	0,	0,	5,	0,	36,	4,
						23,	23,	22,	20,	0,	0,	0,	1,	1,	20,	1,	1,	4,
						20,	23,	21,	20,	0,	0,	0,	0,	0,	0,	0,	37,	4,
						11,	20,	22,	20,	0,	0,	0,	1,	1,	20,	1,	1,	4,
						20,	23,	21,	20,	0,	0,	0,	0,	0,	0,	0,	1,	4,
						23,	20,	22,	22,	0,	0,	0,	0,	0,	0,	0,	1,	4,
						1,	1,	20,	20,	22,	0,	0,	0,	0,	0,	0,	35,	4,
						1,	33,	21,	22,	22,	1,	1,	1,	1,	1,	1,	1,	1,
						1,	1,	1,	1,	1,	1,	1,	1,	1,	1,	1,	1,	1
					],
	"signs":	[]
}