{
	"name":		"One Side To The Next",
	"width":	14,
	"height":	12,
	"board_array":	[
						1,	0,	0,	0,	0,	0,	0,	1,	0,	0,	24,	23,	0,	0,
						1,	0,	5,	0,	0,	0,	0,	1,	0,	0,	24,	23,	0,	0,
						1,	1,	1,	1,	0,	0,	10,	1,	11,	0,	24,	23,	0,	0,
						1,	0,	0,	0,	0,	0,	1,	1,	1,	0,	24,	23,	0,	0,
						1,	0,	0,	0,	0,	0,	0,	1,	0,	5,	24,	23,	0,	0,
						1,	0,	0,	1,	1,	1,	1,	1,	1,	1,	1,	1,	0,	0,
						1,	0,	0,	0,	0,	0,	31,	1,	30,	0,	0,	5,	0,	0,
						1,	0,	0,	0,	0,	0,	1,	1,	1,	0,	0,	20,	0,	0,
						1,	1,	1,	1,	1,	0,	0,	0,	0,	0,	0,	0,	0,	62,
						1,	0,	0,	0,	20,	0,	0,	1,	0,	0,	21,	21,	1,	1,
						1,	0,	39,	0,	20,	0,	0,	0,	0,	0,	21,	38,	1,	1,
						1,	1,	1,	1,	1,	1,	1,	1,	1,	1,	1,	1,	1,	1
					],
	"signs":	[]
}