{
	"name":		"Escher, M. C.",
	"width":	12,
	"height":	10,
	"board_array":	[	
						0,	0,	0,	0,	0,	0,	0,	0,	0,	0,	0,	0,
						0,	0,	0,	0,	0,	0,	0,	0,	1,	1,	0,	0,
						0,	0,	0,	0,	0,	0,	0,	1,	11,	1,	0,	0,
						0,	0,	0,	0,	0,	0,	1,	0,	0,	1,	0,	0,
						0,	0,	0,	0,	0,	1,	0,	0,	0,	1,	0,	0,
						0,	0,	0,	0,	1,	0,	0,	0,	0,	1,	0,	0,
						0,	0,	0,	1,	0,	0,	0,	0,	0,	0,	0,	0,
						0,	0,	1,	0,	0,	0,	0,	0,	0,	0,	0,	0,
						10,	1,	0,	0,	0,	0,	0,	0,	0,	0,	0,	0,
						1,	1,	1,	1,	1,	1,	1,	1,	1,	1,	1,	1
					],
	"signs":	[]
}