{
	"name":		"Powerups!",
	"width":	13,
	"height":	10,
	"board_array":	[	
						0,	0,	0,	0,	0,	0,	0,	0,	0,	0,	0,	0,	0,
						0,	0,	0,	0,	0,	0,	0,	0,	0,	0,	0,	0,	0,
						0,	0,	0,	0,	0,	0,	0,	0,	0,	0,	0,	11,	0,
						10,	0,	0,	0,	0,	0,	0,	0,	0,	0,	1,	1,	1,
						1,	1,	1,	0,	0,	0,	0,	71,	0,	0,	1,	1,	1,
						1,	1,	1,	0,	0,	0,	0,	0,	0,	0,	1,	1,	1,
						1,	1,	1,	0,	0,	0,	0,	0,	0,	0,	1,	1,	1,
						1,	1,	1,	0,	0,	0,	0,	0,	0,	0,	1,	1,	1,
						1,	1,	1,	0,	0,	54,	0,	0,	62,	0,	1,	1,	1,
						1,	1,	1,	1,	1,	1,	1,	1,	1,	1,	1,	1,	1
					],
	"signs":	[
					{"id":54, "text":"Pick up a powerup to add charge!"},
					{"id":71, "text":"Pick up a powerup to add charge!"}
				]
	}