{
	"name":		"level11",
	"width":	16,
	"height":	10,
	"board_array":	[	
						1,	1,	0,	0,	0,	0,	0,	0,	0,	0,	0,	0,	0,	0,	0,	0,
						1,	1,	11,	0,	0,	0,	0,	0,	0,	0,	0,	0,	0,	0,	0,	0,
						1,	1,	1,	1,	0,	0,	0,	0,	0,	0,	0,	0,	5,	0,	0,	0,
						10,	5,	0,	0,	0,	0,	0,	0,	5,	0,	0,	1,	1,	0,	0,	0,
						1,	1,	0,	0,	0,	0,	0,	1,	1,	1,	1,	1,	1,	0,	0,	0,
						1,	1,	0,	0,	0,	0,	0,	0,	0,	0,	0,	0,	0,	0,	0,	0,
						1,	1,	0,	0,	0,	0,	0,	0,	0,	0,	0,	0,	0,	0,	0,	0,
						0,	0,	0,	0,	0,	0,	0,	0,	0,	0,	0,	0,	0,	0,	0,	0,
						0,	0,	0,	0,	0,	0,	0,	0,	0,	0,	0,	0,	0,	0,	0,	0,
						1,	1,	1,	1,	1,	1,	1,	1,	1,	1,	1,	1,	1,	1,	1,	1
					],
	"signs":	[]
}