{
	"name":		"Ascention",
	"width":	12,
	"width":	12,
	"height":	11,
	"board_array":	[	
						1,	1,	1,	1,	4,	0,	0,	0,	0,	0,	0,	1,
						1,	1,	1,	1,	4,	0,	0,	0,	0,	0,	11,	1,
						1,	1,	1,	1,	4,	0,	0,	0,	1,	1,	1,	1,
						1,	1,	1,	1,	4,	0,	0,	0,	4,	1,	1,	1,
						1,	1,	1,	1,	4,	0,	0,	0,	4,	1,	1,	1,
						1,	1,	1,	1,	1,	0,	0,	0,	4,	1,	1,	1,
						1,	10,	0,	0,	0,	0,	0,	0,	4,	1,	1,	1,
						1,	1,	1,	1,	1,	0,	0,	0,	4,	1,	1,	1,
						1,	1,	1,	1,	1,	0,	0,	0,	4,	1,	1,	1,
						1,	1,	1,	1,	1,	0,	0,	0,	1,	1,	1,	1,
						1,	1,	1,	1,	1,	3,	3,	3,	1,	1,	1,	1
					],
	"signs":	[]
}