{
	"name":		"That's A Lot Of Gates",
	"width":	14,
	"height":	12,
	"board_array":	[	
						0,	0,	0,	0,	0,	0,	0,	0,	0,	0,	0,	0,	0,	0,
						10,	0,	0,	0,	0,	0,	54,	0,	0,	0,	5,	0,	0,	4,
						1,	1,	24,	20,	0,	0,  0,	0,	0,	20,	20,	1,	1,	4,
						1,  24,	21,	20,	0,	0,	0,	0,	0,	0,	5,	0,	36,	4,
						23,	23,	24,	20,	0,	0,	0,	0,	1,	20,	20,	1,	1,	4,
						20,	23,	21,	20,	0,	0,	0,	0,	0,	0,	0,	0,	39,	4,
						11,	20,	24,	20,	0,	0,	0,	1,	1,	20,	20,	1,	1,	4,
						20,	23,	21,	20,	0,	0,	0,	0,	0,	0,	0,	0,	1,	4,
						23,	20,	24,	24,	0,	0,	0,	0,	0,	0,	0,	0,	1,	4,
						1,	1,	20,	20,	24,	0,	0,	0,	0,	0,	0,	0,	35,	4,
						1,	33,	21,	24,	24,	1,	1,	1,	1,	1,	1,	1,	1,	1,
						1,	1,	1,	1,	1,	1,	1,	1,	1,	1,	1,	1,	1,	1
					],
	"signs":	[
					{"id":54, "text":"Buttons with arrows pop back up when not pressed"}
				]
}