{
	"name":		"Wastefulness is Key",
	"width":	12,
	"height":	10,
	"board_array":	[	
						0,	0,	0,	0,	0,	0,	2,	2,	2,	2,	2,	2,
						0,	0,	0,	0,	0,	0,	2,	2,	2,	2,	2,	2,
						10,	0,	0,	0,	0,	0,	2,	2,	2,	2,	2,	2,
						1,	1,	0,	0,	0,	0,	2,	2,	2,	2,	2,	2,
						1,	1,	0,	0,	0,	0,	0,	0,	0,	0,	0,	0,
						1,	1,	0,	0,	0,	0,	0,	0,	0,	0,	0,	11,
						1,	1,	0,	0,	0,	0,	0,	0,	0,	1,	1,	1,
						1,	1,	0,	0,	0,	0,	0,	0,	0,	1,	1,	1,
						1,	1,	0,	0,	0,	0,	0,	0,	0,	1,	1,	1,
						1,	1,	1,	1,	1,	1,	1,	1,	1,	1,	1,	1
					],
	"signs":	[]
}