{
	"name":		"Crates!",
	"width":	13,
	"height":	10,
	"board_array":	[	
						0,	0,	0,	0,	0,	0,	0,	0,	0,	0,	0,	0,	0,
						0,	0,	0,	0,	0,	0,	0,	0,	0,	0,	0,	0,	0,
						0,	0,	0,	0,	0,	0,	0,	0,	0,	0,	0,	0,	0,
						10,	0,	0,	0,	0,	0,	0,	0,	0,	0,	0,	0,	11,
						1,	0,	0,	0,	0,	0,	0,	0,	0,	0,	1,	1,	1,
						1,	0,	0,	0,	0,	0,	0,	0,	0,	0,	1,	1,	1,
						1,	0,	0,	0,	0,	0,	0,	0,	0,	0,	1,	1,	1,
						1,	0,	0,	0,	0,	0,	54,	0,	0,	0,	1,	1,	1,
						1,	0,	0,	0,	0,	0,	5,	0,	0,	0,	1,	1,	1,
						1,	1,	1,	1,	1,	1,	1,	1,	1,	1,	1,	1,	1
					],
	"signs":	[
					{"id":54, "text":"You can push and stand on crates"}
				]
	}