{
	"name":		"level5",
	"width":	12,
	"height":	11,
	"board_array":	[	
						1,	10,	0,	0,	0,	1,	0,	0,	0,	0,	0,	1,
						1,	1,	1,	1,	0,	1,	0,	0,	0,	0,	11,	1,
						1,	1,	1,	0,	0,	1,	0,	0,	1,	1,	1,	1,
						1,	1,	1,	0,	0,	1,	0,	0,	1,	1,	1,	1,
						1,	1,	1,	0,	0,	1,	0,	0,	1,	1,	1,	1,
						1,	1,	1,	0,	0,	1,	0,	0,	1,	1,	1,	1,
						1,	1,	1,	0,	50,	1,	0,	0,	1,	1,	1,	1,
						1,	1,	1,	0,	1,	1,	0,	0,	1,	1,	1,	1,
						1,	1,	1,	0,	0,	0,	0,	0,	1,	1,	1,	1,
						1,	1,	1,	0,	0,	0,	0,	0,	1,	1,	1,	1,
						1,	1,	1,	1,	1,	1,	1,	1,	1,	1,	1,	1
					],
	"signs":	[
					{"id":50, "text":"Try Not To Land Here!!"}
				]
}