{
	"name":		"Dodging Platforms",
	"width":	17,
	"height":	13,
	"board_array":	[
					0,0,0,1,0,0,0,0,1,0,0,0,0,1,0,0,0,
					10,0,0,1,0,0,0,0,1,0,0,0,0,1,0,0,11,
					1,0,0,1,0,0,61,0,1,0,0,62,0,1,0,0,1,
					1,0,0,1,0,0,0,0,1,0,0,0,0,1,0,0,1,
					1,0,0,0,40,0,0,0,0,0,0,0,47,0,0,0,1,
					1,0,0,0,0,0,0,0,0,0,0,0,0,0,0,0,1,
					1,0,0,0,0,0,0,0,0,0,0,0,0,0,0,0,1,
					1,0,0,0,0,0,0,0,0,0,0,0,0,0,0,0,1,
					1,0,0,0,0,0,0,0,0,0,0,0,0,0,0,0,1,
					1,0,0,0,0,0,0,0,0,0,0,0,0,0,0,0,1,
					1,0,0,0,0,0,0,0,0,0,0,0,0,0,0,0,1,
					1,0,0,0,0,0,0,0,0,0,0,0,0,0,0,0,1,
					1,3,3,3,3,3,3,3,3,3,3,3,3,3,3,3,1
					],
	"signs":	[]
}