{
	"name":		"Super Crate Bros.",
	"width":	14,
	"height":	11,
	"board_array":	[	
						0,	0,	0,	0,	0,	0,	1,	1,	1,	0,	0,	0,	0,	0,
						0,	0,	0,	0,	0,	0,	1,	1,	1,	0,	0,	0,	0,	0,
						0,	0,	0,	0,	0,	0,	1,	1,	1,	0,	0,	0,	0,	0,
						10,	0,	0,	0,	0,	0,	1,	1,	1,	0,	0,	0,	0,	0,
						1,	1,	1,	0,	0,	0,	1,	1,	1,	0,	0,	0,	0,	11,
						1,	1,	1,	0,	0,	0,	1,	1,	1,	0,	0,	0,	0,	1,
						1,	1,	1,	0,	0,	0,	1,	1,	1,	0,	0,	0,	0,	1,
						0,	0,	0,	0,	0,	0,	1,	1,	1,	0,	0,	0,	0,	1,
						0,	0,	5,	0,	0,	0,	0,	5,	0,	0,	0,	0,	0,	1,
						1,	1,	1,	1,	1,	1,	1,	1,	1,	0,	0,	0,	0,	1,
						1,	1,	1,	1,	1,	1,	1,	1,	1,	1,	1,	1,	1,	1
					],
	"signs":	[]
}