{
	"name":		"level19",
	"width":	13,
	"height":	13,
	"board_array":	[	
						2,	2,	2,	2,	2,	2,	2,	2,	2,	2,	20,	2,	2,
						0,	0,	0,	0,	0,	0,	0,	0,	0,	0,	20,	0,	1,
						30,	0,	0,	0,	0,	0,	0,	0,	0,	0,	20,	0,	1,
						1,	40,	0,	0,	2,	0,	0,	0,	0,	45,	20,	0,	1,
						0,	0,	0,	0,	2,	0,  0,	0,	0,	0,	20,	11,	1,
						10,	0,	0,	0,	0,	0,	0,	0,	0,	0,	1,	1,	1,
						1,	0,	0,	0,	0,	0,	0,	4,	0,	0,	1,	1,	1,
						1,	0,	0,	0,	0,	0,	0,	4,	0,	0,	1,	1,	1,
						1,	0,	0,	0,	2,	0,	0,	4,	0,	0,	1,	1,	1,
						1,	1,	0,	0,	2,	0,	0,	4,	0,	0,	1,	1,	1,
						1,	1,	0,	0,	2,	0,	0,	4,	0,	0,	1,	1,	1,
						1,	1,	0,	0,	2,	0,	0,	4,	0,	0,	1,	1,	1,
						1,	1,	3,	3,	2,	1,	1,	1,	2,	2,	1,	1,	1
					],
	"signs":	[]
}