{
	"name":		"level6",
	"width":	12,
	"height":	10,
	"board_array":	[	
						0,	0,	0,	0,	0,	0,	0,	0,	0,	0,	0,	0,
						0,	0,	0,	0,	0,	0,	0,	0,	0,	0,	0,	0,
						0,	0,	0,	0,	0,	0,	0,	0,	0,	0,	0,	0,
						10,	54,	0,	0,	0,	0,	0,	0,	0,	0,	0,	0,
						1,	1,	0,	0,	0,	0,	0,	0,	0,	0,	0,	0,
						1,	1,	0,	0,	0,	0,	0,	0,	0,	0,	0,	0,
						1,	1,	0,	0,	0,	0,	0,	0,	0,	0,	0,	11,
						1,	1,	0,	0,	0,	0,	0,	0,	0,	1,	1,	1,
						1,	1,	0,	0,	0,	0,	0,	0,	0,	1,	1,	1,
						1,	1,	3,	3,	3,	3,	3,	3,	3,	1,	1,	1
					],
	"signs":	[
					{"id":54, "text":"Trampolines use up your energy immediately!"}
				]
}