{
	"name":		"level19",
	"width":	15,
	"height":	10,
	"board_array":	[	
						0,	2,	2,	2,	2,	2,	23,	23,	2,	2,	2,	2,	2,	2,	2,
						0,	0,	0,	2,	0,	0,	23,	11,	1,	0,	0,	0,	0,	0,	0,
						0,	0,	0,	2,	0,	0,	23,	1,	1,	0,	0,	0,	0,	0,	0,
						10,	0,	0,	2,	0,	0,	0,	0,	1,	0,	5,	0,	0,	0,	0,
						1,	0,	0,	2,	0,	0,	0,	0,	1,	1,	1,	1,	0,	0,	0,
						1,	0,	0,	2,	0,	0,	0,	0,	1,	0,	0,	0,	0,	0,	62,
						1,	0,	0,	2,	0,	0,	0,	0,	1,	0,	0,	0,	0,	0,	1,
						1,	0,	0,	2,	0,	0,	0,	0,	1,	0,	0,	0,	0,	0,	1,
						1,	0,	0,	5,	0,	0,	0,	0,	5,	0,	0,	0,	38,	0,	1,
						1,	1,	1,	1,	1,	1,	1,	1,	1,	1,	1,	1,	1,	1,	1
					],
	"signs":	[]
}