{
	"name":		"The Zipper",
	"width":	12,
	"height":	12,
	"board_array":	[	
						0,	0,	0,	0,	0,	0,	0,	0,	0,	0,	0,	0,
						0,	0,	0,	0,	11,	0,	0,	0,	0,	0,	0,	0,
						0,	0,	0,	0,	1,	0,	0,	0,	0,	0,	0,	0,
						0,	0,	0,	1,	0,	0,	0,	0,	0,	0,	0,	0,
						0,	0,	1,	0,	0,	0,	0,	1,	0,	0,	0,	0,
						0,	1,	0,	0,	0,	0,	0,	0,	1,	0,	0,	0,
						0,	0,	0,	0,	1,	0,	0,	0,	0,	1,	0,	0,
						0,	0,	0,	1,	0,	0,	0,	0,	0,	0,	1,	0,
						0,	10,	1,	0,	0,	0,	0,	0,	0,	0,	0,	0,
						0,	1,	0,	0,	0,	0,	0,	0,	0,	0,	0,	0,
						0,	0,	0,	0,	0,	0,	0,	0,	0,	0,	0,	0,
						1,	1,	1,	1,	1,	1,	1,	1,	1,	1,	1,	1
					],
	"signs":	[]
	}