{
	"name":		"Learn to Fly",
	"width":	13,
	"height":	10,
	"board_array":	[	
						0,	0,	0,	0,	0,	0,	0,	0,	0,	0,	0,	0,	0,
						0,	0,	0,	0,	0,	0,	0,	0,	0,	0,	0,	0,	0,
						0,	0,	0,	0,	0,	0,	0,	0,	0,	0,	0,	0,	0,
						10,	54,	0,	0,	0,	0,	0,	0,	0,	0,	0,	0,	0,
						1,	1,	1,	0,	0,	0,	0,	0,	0,	0,	0,	0,	0,
						1,	1,	1,	0,	0,	0,	0,	0,	0,	0,	0,	0,	0,
						1,	1,	1,	0,	0,	0,	0,	0,	0,	0,	0,	0,	11,
						1,	1,	1,	0,	0,	0,	0,	0,	0,	0,	1,	1,	1,
						1,	1,	1,	0,	0,	0,	0,	0,	0,	55,	1,	1,	1,
						1,	1,	1,	1,	1,	1,	1,	1,	1,	1,	1,	1,	1
					],
	"signs":	[
					{"id":54, "text":"Fall off the ledge to build up energy!"},
					{"id":55, "text":"Press space to spring using your stored energy!"}
				]
	}