{
	"name":		"level0",
	"width":	13,
	"height":	10,
	"board_array":	[	
						0,	0,	0,	0,	0,	0,	0,	0,	0,	0,	0,	0,	0,
						0,	0,	0,	0,	0,	0,	0,	0,	0,	0,	0,	0,	0,
						0,	0,	0,	0,	0,	0,	0,	0,	0,	0,	0,	0,	0,
						0,	0,	0,	0,	0,	0,	0,	0,	0,	0,	0,	0,	0,
						0,	0,	0,	0,	0,	0,	0,	0,	0,	0,	0,	0,	0,
						0,	0,	0,	0,	0,	0,	0,	0,	0,	0,	0,	0,	0,
						0,	0,	0,	0,	0,	0,	0,	0,	0,	0,	0,	1,	0,
						0,  10,	0,	0,	0,	0,	0,	0,	0,	0,	1,	1,	0,
						0,  54,	0,	0,	0,	0,	0,	0,	56,	1,	1,	1,	11,
						1,	1,	1,	1,	1,	1,	1,	1,	1,	1,	1,	1,	1
					],
	"signs":	[
					{"id":54, "text":"Press the left or right arrow to move"},
                    {"id":56, "text":"Press the up arrow to jump"}
				]
	}