{
	"name":		"Closed Off",
	"width":	14,
	"height":	12,
	"board_array":	[	
						0,	0,	1,	1,	1,	1,	1,	0,	0,	0,	0,	0,	0,	1,
						10,	0,	1,	0,	0,	0,	1,	0,	0,	0,	0,	0,	0,	1,
						1,	0,	1,	0,	30,	0,	1,	0,	0,	0,	0,	0,	0,	1,
						1,	0,	1,	0,	1,	0,	1,	31,	0,	0,	0,	0,	34,	1,
						1,	0,	0,	0,	0,	0,	1,	1,	0,	0,	0,	0,	1,	1,
						1,	1,	1,	20,	20,	1,	1,	0,	0,	0,	0,	0,	0,	1,
						1,	1,	1,	0,	0,	0,	0,	0,	0,	0,	0,	0,	0,	1,
						1,	1,	1,	0,	0,	0,	0,	0,	0,	0,	0,	0,	0,	1,
						1,	1,	1,	1,	1,	1,	1,	1,	1,	21,	21,	1,	1,	1,
						1,	1,	1,	1,	1,	1,	1,	1,	1,	24,	24,	1,	1,	1,
						1,	1,	1,	1,	1,	1,	1,	1,	1,	0,	11,	1,	1,	1,
						1,	1,	1,	1,	1,	1,	1,	1,	1,	1,	1,	1,	1,	1
					],
	"signs":	[]
}