{
	"name":		"The Definition of Insanity",
	"width":	18,
	"height":	13,
	"board_array":	[	
						1,	1,	1,	0,	0,	0,	0,	0,	0,	0,	0,	0,	0,	0,	0,	1,	1,	1,
						1,	1,	1,	0,	0,	0,	0,	10,	0,	0,	0,	1,	1,	1,	4,	1,	1,	1,
						1,	1,	1,	0,	0,	0,	1,	1,	1,	0,	0,	0,	30,	1,	4,	1,	1,	1,
						0,	0,	0,	0,	0,	0,	0,	0,	0,	0,	0,	0,	1,	1,	4,	1,	0,	11,
						0,	5,	0,	0,	0,	0,	1,	1,	1,	0,	0,	0,	1,	1,	4,	1,	0,	1,
						1,	1,	1,	0,	0,	0,	0,	0,	0,	0,	0,	0,	1,	1,	4,	1,	0,	1,
						1,	1,	1,	0,	0,	0,	1,	1,	1,	0,	0,	0,	0,	0,	4,	1,	0,	1,
						1,	1,	1,	0,	0,	0,	1,	1,	1,	0,	0,	0,	1,	1,	1,	1,	0,	1,
						1,	0,	0,	0,	0,	0,	1,	1,	1,	0,	0,	0,	1,	1,	1,	1,	0,	1,
						1,	20,	1,	20,	20,	1,	1,	1,	1,	3,	3,	3,	1,	1,	1,	1,	0,	1,
						0,	0,	1,	1,	1,	1,	1,	1,	1,	1,	1,	1,	1,	1,	1,	0,	0,	1,
						0,	0,	0,	0,	0,	0,	0,	0,	0,	0,	0,	0,	0,	0,	0,	0,	0,	1,
						1,	1,	1,	1,	1,	1,	1,	1,	1,	1,	1,	1,	1,	1,	1,	1,	2,	1
					],
	"signs":	[
					
				]
}