{
	"name":		"Compilation",
	"width":	12,
	"height":	11,
	"board_array":	[	
						1,	1,	1,	0,	0,	0,	0,	0,	0,	0,	0,	1,
						1,	1,	1,	0,	0,	0,	0,	0,	0,	0,	0,	1,
						1,	1,	1,	0,	1,	1,	1,	1,	0,	0,	0,	1,
						1,	1,	1,	0,	0,	0,	0,	0,	0,	0,	0,	1,
						10,	0,	0,	0,	0,	0,	0,	0,	0,	0,	11,	1,
						1,	4,	0,	0,	0,	0,	0,	0,	0,	1,	1,	1,
						1,	4,	0,	0,	0,	0,	0,	0,	0,	1,	1,	1,
						1,	4,	0,	0,	0,	0,	0,	0,	0,	1,	1,	1,
						1,	4,	0,	0,	0,	0,	0,	0,	0,	1,	1,	1,
						1,	4,	0,	0,	0,	0,	0,	0,	0,	1,	1,	1,
						1,	1,	1,	1,	2,	2,	2,	2,	1,	1,	1,	1
					],
	"signs":	[]
}