{
	"name":		"level3",
	"width":	11,
	"height":	9,
	"board_array":	[	
						0,	0,	1,	1,	1,	0,	0,	0,	0,	0,	1,
						10,	0,	1,	1,	1,	0,	0,	0,	0,	0,	1,
						1,	0,	1,	1,	1,	0,	0,	0,	0,	0,	1,
						1,	0,	0,	1,	1,	0,	0,	0,	0,	11,	1,
						1,	0,	0,	1,	1,	0,	0,	1,	1,	1,	1,
						1,	1,	0,	1,	1,	0,	0,	1,	1,	1,	1,
						1,	1,	0,	1,	1,	0,	0,	1,	1,	1,	1,
						1,	1,	0,	0,	0,	0,	0,	1,	1,	1,	1,
						1,	1,	1,	1,	1,	1,	1,	1,	1,	1,	1
					],
	"signs":	[]
}