{
	"name":		"level14",
	"width":	18,
	"height":	13,
	"board_array":	[	
						1,	1,	1,	1,	5,	0,	0,	5,	0,	0,	0,	0,	0,	0,	0,	0,	0,	0,
						1,	1,	1,	1,	20,	0,	5,	5,	0,	0,	0,	0,	0,	0,	0,	0,	0,	0,
						1,	1,	1,	1,	0,	5,	5,	5,	0,	0,	0,	0,	0,	0,	0,	0,	0,	0,
						1,	1,	1,	1,	21,	21,	22,	23,	0,	0,	0,	0,	0,	0,	0,	0,	0,	0,
						1,	1,	1,	1,	0,	0,	0,	0,	0,	0,	0,	0,	0,	0,	0,	0,	0,	0,
						0,	0,	0,	1,	0,	0,	0,	0,	0,	0,	0,	0,	0,	0,	0,	0,	0,	11,
						4,	1,	0,	1,	0,	0,	0,	0,	0,	0,	0,	0,	1,	1,	1,	1,	1,	1,
						4,	1,	0,	10,	0,	0,	0,	0,	0,	0,	0,	0,	4,	4,	4,	4,	4,	4,
						4,	1,	3,	1,	1,	1,	1,	1,	0,	0,	0,	0,	4,	0,	33,	30,	32,	31,
						4,	1,	1,	1,	1,	1,	1,	1,	0,	0,	0,	0,	4,	0,	23,	20,	22,	21,
						4,	1,	1,	1,	1,	1,	1,	1,	3,	3,	3,	3,	1,	0,	0,	0,	0,	0,
						4,	0,	0,	0,	0,	0,	0,	0,	0,	0,	0,	0,	0,	0,	0,	0,	0,	0,
						1,	1,	1,	1,	1,	1,	1,	1,	1,	1,	1,	1,	1,	1,	3,	3,	3,	3
					],
	"signs":	[]
}