{
	"name":		"level16",
	"width":	20,
	"height":	19,
	"board_array":	[	
						1,	1,	1,	1,	0,	0,	0,	0,	0,	0,	0,	0,	0,	0,	0,	0,	0,	0,	0,	0,
						1,	1,	1,	1,	0,	0,	0,	5,	30,	0,	0,	0,	0,	0,	0,	0,	0,	0,	0,	0,
						1,	1,	1,	1,	0,	0,	1,	1,	1,	1,	0,	0,	0,	0,	0,	0,	0,	0,	0,	0,
						0,	23,	0,	0,	0,	0,	1,	1,	5,	1,	1,	0,	0,	0,	0,	0,	0,	0,	0,	0,
						11,	22,	0,	0,	0,	0,	1,	1,	20,	1,	1,	1,	0,	0,	0,	0,	0,	0,	0,	0,
						1,	0,	0,	0,	0,	0,	1,	1,	21,	1,	1,	1,	1,	1,	0,	0,	0,	0,	0,	0,
						10,	0,	0,	0,	0,	0,	0,	0,	0,	0,	0,	0,	0,	0,	0,	0,	0,	0,	0,	0,
						1,	0,	0,	0,	0,	0,	0,	5,	0,	0,	5,	0,	0,	0,	0,	0,	0,	0,	0,	0,
						1,	0,	0,	0,	0,	0,	1,	1,	1,	1,	1,	1,	1,	1,	1,	0,	0,	0,	0,	0,
						1,	0,	0,	0,	0,	0,	0,	0,	0,	1,	1,	1,	0,	0,	0,	0,	0,	0,	0,	0,
						1,	0,	0,	0,	0,	0,	0,	5,	0,	0,	0,	0,	36,	5,	0,	0,	0,	0,	0,	0,
						1,	0,	0,	0,	0,	0,	1,	1,	1,	1,	1,	1,	1,	1,	1,	1,	0,	0,	0,	0,
						1,	0,	0,	0,	0,	0,	0,	0,	0,	1,	1,	1,	0,	0,	0,	0,	0,	0,	0,	0,
						1,	0,	0,	0,	0,	0,	0,	5,	0,	0,	0,	0,	0,	5,	0,	0,	0,	0,	0,	4,
						1,	0,	0,	0,	0,	0,	1,	1,	1,	1,	4,	1,	1,	1,	1,	1,	1,	0,	0,	4,
						1,	0,	0,	0,	0,	0,	0,	0,	0,	1,	4,	1,	0,	0,	0,	0,	0,	0,	0,	4,
						1,	0,	0,	0,	0,	1,	0,	0,	0,	1,	4,	1,	0,	0,	0,	0,	0,	0,	0,	4,
						1,	37,	38,	0,	1,	1,	1,	0,	0,	0,	4,	0,	0,	0,	0,	0,	0,	0,	0,	4,
						1,	1,	1,	1,	1,	1,	1,	1,	1,	1,	1,	1,	1,	1,	1,	1,	1,	1,	1,	1
					],
	"signs":	[]
}