{
	"name":		"level19",
	"width":	13,
	"height":	10,
	"board_array":	[	
						0,	2,	2,	2,	2,	2,	2,	2,	2,	2,	2,	2,	2,
						0,	0,	2,	0,	0,	0,	24,	11,	1,	0,	0,	0,	0,
						0,	0,	2,	0,	0,	0,	1,	1,	1,	0,	0,	0,	0,
						10,	0,	2,	0,	0,	0,	0,	0,	1,	0,	0,	0,	0,
						1,	0,	2,	0,	0,	0,	0,	0,	1,	0,	0,	0,	0,
						1,	0,	2,	0,	0,	0,	0,	0,	1,	0,	0,	0,	62,
						1,	0,	2,	0,	0,	0,	0,	0,	1,	0,	0,	0,	1,
						1,	0,	2,	0,	0,	0,	0,	0,	1,	0,	0,	0,	1,
						1,	0,	5,	0,	0,	5,	0,	0,	5,	0,	39,	0,	1,
						1,	1,	1,	1,	1,	1,	1,	1,	1,	1,	1,	1,	1
					],
	"signs":	[]
}