{
	"name":		"level19",
	"width":	13,
	"height":	12,
	"board_array":	[	
						0,	0,	0,	0,	0,	0,	0,	0,	0,	0,	0,	0,	0,
						0,	0,	0,	0,	0,	0,	0,	0,	0,	0,	0,	0,	0,
						10,	0,	0,	0,	0,	0,	0,	0,	0,	0,	0,	30,	0,
						1,	1,	0,	0,	0,	2,  2,	0,	0,	0,	0,	1,	1,
						1,	2,	0,	0,	0,	0,	65,	0,	0,	0,	0,	1,	1,
						1,	2,	0,	0,	0,	0,	0,	0,	0,	0,	0,	1,	1,
						1,	2,	0,	0,	0,	0,	0,	0,	0,	0,	0,	1,	1,
						1,	2,	0,	0,	0,	0,	0,	0,	0,	0,	0,	1,	1,
						1,	20,	0,	0,	2,	0,	0,	0,	2,	0,	0,	1,	1,
						11,	20,	0,	0,	2,	0,	0,	0,	2,	0,	0,	1,	1,
						1,	1,	0,	0,	2,	0,	0,	0,	2,	0,	0,	1,	1,
						1,	1,	3,	3,	3,	3,	3,	3,	3,	3,	3,	1,	1
					],
	"signs":	[]
}