{
	"name":		"level23",
	"width":	16,
	"height":	11,
	"board_array":	
				[
					0,0,0,1,2,2,2,2,2,2,2,2,2,2,2,2,
					0,0,0,1,0,21,22,20,23,21,23,22,0,0,0,0,
					0,0,0,1,11,20,23,21,20,22,20,23,0,0,0,0,
					10,0,0,1,1,1,1,1,1,1,1,1,1,1,0,0,
					1,0,0,0,0,0,0,0,0,0,0,0,0,0,0,0,
					1,0,0,0,0,0,0,0,0,0,0,0,0,0,0,0,
					1,0,0,0,0,0,0,0,0,0,0,0,0,0,0,0,
					1,0,0,0,0,0,0,0,0,0,0,0,0,0,0,0,
					1,64,0,63,0,64,0,63,0,64,0,63,0,64,0,63,
					1,0,0,30,0,0,31,0,0,0,32,0,0,33,0,0,
					1,3,3,3,3,3,3,3,3,3,3,3,3,3,3,3
				],
	"signs":	[]
}