{
	"name":		"Go Back",
	"width":	14,
	"height":	10,
	"board_array":	[
                        0,	0,	0,	0,	0,  0,	0,	0,	0,	0,	0,	0,	0,	0,
                        0,	0,	0,	0,	0,  0,	0,	0,	0,	0,	0,	0,	0,	0,
                        0,	0,	0,	0,	0,  0,	0,	0,	0,	0,	0,	0,	0,	0,
                        0,	0,	0,	0,	0,  0,	0,	0,	0,	0,	0,	0,	0,	0,
                        0,	0,	0,	0,	0,  0,	0,	0,	0,	0,	0,	0,	0,	0,
                        0,	0,	0,	0,	0,  0,	0,	0,	0,	0,	0,	0,	0,	0,
                        0,	54,	1,	0,	0,  1,	0,	0,	1,	0,	0,	1,	0,	0,
                        10,	1,	1,	4,	0,  0,	0,	0,	0,	0,	0,	1,	1,	11,
                        1,	1,	1,	4,	0,  0,	0,	0,	0,	0,	0,	1,	1,	1,
                        1,	1,	1,	1,	1,  1,	1,	1,	1,	1,	1,	1,	1,	1
					],
	"signs":	[
					{"id":54, "text":"Press R to rewind and Y to reset"}
    ]
	}