{
	"name":		"level8",
	"width":	10,
	"height":	10,
	"board_array":	[
						0,	0,	0,	0,	0,	0,	0,	0,	0,	0,		
						0,	0,	0,	0,	0,	0,	0,	0,	5,	0,	
						1,	0,	0,	0,	0,	0,  0,	0,	1,	1,	
						10,	0,	0,	0,	0,	0,	0,	0,	1,	1,	
						1,	0,	0,	0,	0,	0,	0,	0,	20,	11,
						4,	0,	0,	0,	0,	0,	0,	0,	1,	1,	
						4,	0,	0,	0,	0,	0,	0,	0,	0,	0,	
						30,	0,	0,	0,	0,	0,	0,	0,	5,	0,	
						4,	45,	0,	0,	0,	52,	0,	1,	1,	1,	
						1,	1,	1,	1,	1,	1,	1,	1,	1,	1	
					],
	"signs":	[]
}