{
	"name":		"test2",
	"width":	15,
	"height":	10,
	"board_array":	[	
						0,	0,	0,	0,	0,	0,	0,	0,	0,	0,	0,	0,	0,	0,	0,
						10,	5,	0,	1,	0,	5,	0,	0,	0,	5,	0,	3,	0,	0,	0,
						1,	1,	1,	1,	1,	1,	1,	1,	1,	1,	1,	1,	0,	0,	0,
						0,	0,	0,	0,	0,	0,	0,	0,	0,	0,	0,	0,	0,	0,	0,
						0,	0,	30,	5,	0,	5,	0,	5,	0,	4,	0,	5,	0,	5,	0,
						0,	1,	1,	1,	1,	1,	1,	1,	1,	1,	1,	1,	1,	0,	1,
						0,	0,	0,	0,	0,	0,	0,	0,	0,	0,	0,	0,	0,	0,	0,
						0,	5,	0,	20,	0,	5,	0,	21,	0,	0,	11,	0,	0,	0,	0,
						1,	1,	1,	1,	1,	1,	1,	1,	1,	1,	1,	0,	0,	5,	0,
						0,	0,	0,	0,	0,	0,	0,	0,	0,	0,	0,	1,	1,	1,	1
					],
	"signs":	[
					{"id":50, "text":"Fall off the ledge to build up energy!"},
					{"id":51, "text":"Press space to use your stored energy!"}
				]
}