{
	"name":		"test1",
	"width":	13,
	"height":	10,
	"board_array":	[	
						0,	0,	0,	0,	0,	0,	0,	0,	0,	0,	1,	0,	0,
						0,	0,	0,	40,	0,	0,	0,	45,	0,	0,	1,	0,	0,
						0,	0,	0,	41,	0,	0,	0,	46,	0,	0,	1,	0,	0,
						10,	0,	30,	0,	0,	0,	0,	0,	0,	0,	1,	0,	0,
						1,	1,	1,	1,	20,	0,	0,	0,	0,	0,	1,	0,	0,
						1,	1,	4,	0,	0,	1,	1,	2,	0,	0,	20,	0,	0,
						1,	1,	4,	0,	0,	0,	0,	0,	0,	0,	20,	0,	11,
						1,	1,	4,	0,	0,	0,	0,	0,	0,	0,	1,	1,	1,
						1,	1,	4,	0,	0,	0,	0,	0,	0,	0,	1,	1,	1,
						1,	1,	1,	3,	1,	1,	1,	1,	1,	1,	1,	1,	1
					]
}