{
	"name":		"test2",
	"width":	14,
	"height":	10,
	"board_array":	[	
						0,	0,	0,	0,	0,	0,	0,	0,	0,	0,	0,	0,	0,	0,
						0,	0,	0,	0,	5,	0,	5,	0,	5,	0,	5,	0,	0,	0,
						0,	0,	0,	0,	0,	0,	0,	0,	0,	0,	0,	0,	0,	0,
						10,	0,	5,	0,	0,	0,	0,	0,	0,	0,	0,	0,	0,	0,
						1,	1,	1,	1,	0,	0,	0,	0,	0,	0,	0,	20,	0,	0,
						1,	1,	1,	1,	0,	0,	0,	0,	0,	0,	0,	0,	0,	0,
						1,	1,	1,	1,	0,	0,	0,	0,	0,	0,	0,	0,	0,	11,
						1,	1,	1,	1,	0,	0,	0,	0,	0,	0,	0,	1,	1,	1,
						1,	1,	1,	1,	0,	0,	30,	0,	0,	0,	0,	1,	1,	1,
						1,	1,	1,	1,	1,	1,	1,	1,	2,	1,	1,	1,	1,	1
					],
	"signs":	[
					{"id":50, "text":"Fall off the ledge to build up energy!"},
					{"id":51, "text":"Press space to use your stored energy!"}
				]
}