{
	"name":		"test2",
	"width":	13,
	"height":	10,
	"board_array":	[	
						0,	0,	0,	0,	0,	0,	0,	0,	0,	0,	0,	0,	0,
						0,	0,	0,	0,	0,	0,	0,	0,	0,	0,	0,	0,	0,
						0,	0,	0,	0,	0,	0,	0,	0,	0,	0,	0,	0,	0,
						10,	0,	50,	0,	0,	0,	0,	0,	0,	0,	0,	0,	0,
						1,	1,	1,	1,	0,	0,	0,	0,	0,	0,	0,	0,	0,
						1,	1,	1,	1,	0,	0,	0,	0,	0,	0,	0,	0,	0,
						1,	1,	1,	1,	0,	0,	0,	0,	0,	0,	0,	0,	11,
						1,	1,	1,	1,	0,	0,	0,	0,	0,	0,	1,	1,	1,
						1,	1,	1,	1,	0,	0,	0,	0,	51,	0,	1,	1,	1,
						1,	1,	1,	1,	1,	1,	1,	1,	1,	1,	1,	1,	1
					],
	"signs":	[
					{"id":50, "text":"Fall off the ledge to build up energy!"},
					{"id":51, "text":"Press space to use your stored energy!"}
				]
}