{
	"name":		"level8",
	"width":	10,
	"height":	10,
	"board_array":	[
						30,	0,	0,	0,	0,	0,	0,	0,	0,	0,		
						1,	0,	0,	0,	0,	0,	0,	0,	0,	0,	
						10,	0,	0,	0,	0,	0,	0,	0,	1,	1,	
						1,	0,	0,	0,	0,	0,	0,	0,	1,	1,	
						4,	0,	0,	0,	2,	20,	0,	0,	20,	11,
						4,	0,	0,	0,	0,	0,	0,	0,	1,	1,	
						4,	0,	0,	0,	0,	0,	0,	0,	1,	1,	
						4,	0,	0,	0,	0,	0,	0,	0,	1,	1,	
						4,	0,	0,	0,	0,	0,	0,	0,	1,	1,	
						1,	1,	1,	1,	1,	1,	1,	2,	1,	1	
					],
	"signs":	[]
}